7777777777777777777777777777
7222222222222112222222222227
7211112111112112111112111127
7310012100012112100012100137
7211112111112112111112111127
7222222222222222222224222227
7211112112111111112112111127
7211112112111111112112111127
7222222112222112222112222227
7777772111110110111112777777
0000072111110110111112700000
00000721100000R0000112700000
0000072110111001110112700000
7777772110100000010112777777
500000200010BOI0010002000005
7777772110100000010112777777
0000072110111111110112700000
0000072110000000000112700000
0000072110111111110112700000
7777772110111111110112777777
7222224222222112222222222227
7211112111112112111112111127
7211112111112112111112111127
73221122222222P2222222112237
7112112112111111112112112117
7112112112111111112112112117
7222222112222112222112222227
7211111111112112111111111127
7211111111112112111111111127
7222222222222222222222222227
7777777777777777777777777777